0000000000
0111111100
0111111100
0111111100
0111110000
0111111100
0111110100
0111110100
0000000110
0000000000
