0000000000
0111100110
0000110100
0011100100
0110000110
0011111110
0110010010
0011111010
0010000010
0000000000