0000000000
0100000000
0111100000
0000100000
0000100000
0000100000
0000111000
0000001110
0000000010
0000000000
